APOKALUNMATA	A)POKALU/MMATA
SUNPWNOUNTWN	SUMPWNOU/NTWN
SUNKLISANTES	SUGKLI/SANTES
SUNKEKLISMENOS	SUGKEKLISME/NOS
ANANKAION	A)NAGKAI=ON
ECELENCAI	E)CELE/GCAI
DIAPRATTWMENW	DIAPRASSWME/NW
BOTTOS	BO/SSOS
ARXANGELO	A)RXA/GGELO
NUMBER_0	I-number
KARR	KA/RS
NAUTTIKOU	NAUSSIKOU=
AGKURRE	A)/GKURSE
SANPER	SA/N
PARANGELIAS	PARAGGELI/AS
SUNXWRHSASA	SUGXWRH/SASA
ENKEFALOS	E)GKE/FALOS
SUSSTHSAS	SUSTH/SAS
ANANKAIWN	A)NAGKAI/WN
MUREYIN	MURE/YION
PROSANGELMATI	PROSAGGE/LMATI
BURRAN	BU/RSAN
HPER	H(
DIAISIN	DIAI/SION
SUNKLISWMEN	SUGKLI/SWMEN
ENKUKLIOU	E)GKUKLI/OU
DHMOSIN	DHMO/SION
HLATTOUMENOU	H)LASSOUME/NOU
DIENGUHMATOS	DIEGGUH/MATOS
ENBATIKOUS	E)MBATIKOU/S
SUNKURWNTA	SUGKURW=NTA
SUNPEFONHMENHN	SUMPEFONHME/NHN
ENGUOI	E)/GGUOI
SUNPARIMI	SUMPA/RIMI
SEBENNIN	SEBE/NNION
ONPERIFORON	O)MPERIFO/RON
ENKALESIN	E)GKA/LESIN
BORRIW	*BORSI/W
MANGANOIS	MAGGA/NOIS
ANKURAIS	A)GKU/RAIS
ALLHLENGUWN	A)LLHLEGGU/WN
OIKONOMIN	OI)KONOMI/ON
ANFOTERAI	A)MFO/TERAI
ENGOI	E)/GGOI
ANGIA	A)GGI/A
KATANGISATAI	KATAGGI/SATAI
SESHMANMENWN	SESHMAMME/NWN
PARESUNGRAFH	PARESUGGRA/FH
HTTO	*(HSSO/
ENKATALIYE	E)GKATA/LIYE
SUNGENOUS	SUGGENOU=S
PRINKIPOS	PRI/GKIPOS
ISANGELIAS	I)SAGGELI/AS
ENGISTA	E)/GGISTA
PREZBUTWN	PRESBUTW=N
PONPHIOU	*POMPHI/OU
GEWRGIN	GEW/RGION
UIPER	UI(=
EPENYAS	E)/PEMYAS
EPENYA	E)/PEMYA
EFQENCATO	E)FQE/GCATO
KERAMIN	KERA/MION
KARNARIN	KARNA/RION
ANANKHN	A)NA/GKHN
OCURUNXON	O)CU/RUGXON
ENBEBLHQAI	E)MBEBLH=QAI
PINKERNHS	PIGKE/RNHS
ENKALEW	E)GKALE/W
YALTHRIN	YALTH/RION
KATENGEGUHMENWN	KATEGGEGUHME/NWN
ENKALOUMENO	E)GKALOU/MENO
SUNXWRHSIN	SUGXW/RHSIN
SUNXWRHSEWS	SUGXWRH/SEWS
APER	A(
ENKEKLHKA	E)GKE/KLHKA
ENPORWN	E)MPO/RWN
ENBLHQHNAI	E)MBLHQH=NAI
SUNPEPTWKUIAN	SUMPEPTWKUI=AN
SUNMIKTA	SU/MMIKTA
ENLIPONTA	E)LLIPO/NTA
ANANKASON	A)NA/GKASON
ENKALW	E)GKALW=
SUNLABANEIN	SULLABA/NEIN
ANHNKASE	A)NH/GKASE
SUNPROSGENOMENOS	SUMPROSGENO/MENOS
ANANKAS	A)NA/GKAS
SUNKEFALWSIN	SUGKEFALW=SIN
IMATIN	I(MA/TION
IMATIN	I(MA/TION
ENGINOMENON	E)GGINO/MENON
ENBALOMAI	E)MBA/LOMAI
ENBALH	E)MBA/LH
ENKALOUMEN	E)GKALOU=MEN
SAFWNIN	SAFW/NION
ENKALOUMENON	E)GKALOU/MENON
ALLHLENGGUHS	A)LLHLEGGU/HS
ENTUNXAN	E)NTU/GXAN
ENPROSQEN	E)/MPROSQEN
KATAKEXWRIZMENON	KATAKEXWRISME/NON
KAMHLIN	KAMH/LION
ANAFORIN	A)NAFO/RION
APUNXIS	*)APU=GXIS
ENGUW	E)GGUW=
SUNPLEOUSHS	SUMPLEOU/SHS
SUNKEKRIMENOIS	SUGKEKRIME/NOIS
ENLEIPEIN	E)LLEI/PEIN
SUNPROOU	SUMPROOU=
ANHNENKEN	A)NH/NEGKEN
EPENENKWSI	E)PENE/GKWSI
ENTUNXANONTES	E)NTUGXA/NONTES
PENPTOU	PE/MPTOU
PROSHNENKATO	PROSHNE/GKATO
ENKOIMHTRO	E)GKOI/MHTRO
KAPER	KA
EPENENKW	E)PENE/GKW
SUNEKPENFQHSOMENWN	SUNEKPEMFQHSOME/NWN
KATAPER	KATA/
ELENXO	E)/LEGXO
EPANANKASAI	E)PANAGKA/SAI
ENGUOU	E)GGU/OU
EPENENKWSIN	E)PENE/GKWSIN
ANENENKWMEN	A)NENE/GKWMEN
SUNKRISEIS	SUGKRI/SEIS
ELENXOMAI	E)LE/GXOMAI
SUNXWRHSEIN	SUGXWRH/SEIN
WRIZMENW	W(RISME/NW
ENFANH	E)MFANH=
EPENENKH	E)PENE/GKH
SUNXRHSAMENOI	SUGXRHSA/MENOI
SUNXWRHSIS	SUGXW/RHSIS
ENTUNXANEIN	E)NTUGXA/NEIN
PROGEGRANMENA	PROGEGRAMME/NA
ALLHLENGUON	A)LLHLE/GGUON
ALLHLENGUHS	A)LLHLEGGU/HS
ANANKAIWS	A)NAGKAI/WS
ENENKE	E)/NEGKE
ENKALOUMENOU	E)GKALOUME/NOU
SUNMETEXOMEN	SUMMETE/XOMEN
QERIZMON	QERISMO/N
APENENKATW	A)PENEGKA/TW
KORKODILOTAFIN	KORKODILOTA/FION
SUNGENESEI	SUGGENE/SEI
ENGAREUQEISA	E)GGAREUQEI=SA
SENPRWNIOS	*SEMPRW/NIOS
ARSENIN	A)RSE/NION
LONGINIA	*LOGGINI/A
ENGU	E)GGU/
POLEMIN	POLE/MION
ENGUWMAI	E)GGUW=MAI
NOMIZMATOS	NOMI/SMATOS
ALLHLENGUOIS	A)LLHLEGGU/OIS
ENGUATAI	E)GGUA=TAI
ENLIMMATOS	E)LLI/MMATOS
ENPOIHSEOS	E)MPOIH/SEOS
SUNXORW	SUGXO/RW
MENFEWS	*MEMFE/WS
ENGUHTOU	E)GGUHTOU=
ENGUS	E)GGU/S
EFIDIN	*)EFI/DION
ARGUREIDIN	A)RGUREI/DION
SUNBWLOU	SUMBW/LOU
ENGEGUHSQE	E)GGEGU/HSQE
SUNKURONTA	SUGKU/RONTA
SUNBWLW	SUMBW/LW
ENKALEIN	E)GKALEI=N
PARASUNGRAFHSI	PARASUGGRA/FHSI
ANANKASETAI	A)NAGKA/SETAI
APOLABIN	A)POLA/BION
ANANKASQHSONTAI	A)NAGKASQH/SONTAI
PENYW	PE/MYW
APENENKW	A)PENE/GKW
ANANKAIOTERON	A)NAGKAIO/TERON
SUNXWRHSE	SUGXW/RHSE
SUNKLEISO	SU/GKLEISO
AMFIZBHTHSEWS	A)MFISBHTH/SEWS
LAGHNIN	LAGH/NION
MARSIPPIN	MARSI/PPION
EPANANKON	E)PA/NAGKON
ENGEGRAMMENOU	E)GGEGRAMME/NOU
PARHNGEILA	PARH/GGEILA
ELLATTOUMENOU	E)LLASSOUME/NOU
ANENKLHTOS	A)NE/GKLHTOS
ALLHLENGUOI	A)LLHLE/GGUOI
ETUNXANEN	E)TU/GXANEN
LONGON	LOGGO/N
ENGUOIS	E)GGU/OIS
SUNKOLHSIN	SUGKO/LHSIN
SUNYWSIN	SUMYW=SIN
PARANGELW	PARAGGELW=
ANENENKONTOS	A)NENEGKO/NTOS
ENGOUOI	E)/GGOUOI
METENENKEIN	METENEGKEI=N
EF'	E)PI/
ENOIKIN	E)NOI/KION
SUNKEIMENOS	SUGKEI/MENOS
SUNXRHMATICESQAI	SUGXRHMATI/CESQAI
EPISTOLIN	E)PISTO/LION
ANGIO	A)GGI/O
ANGU	*)/AGGU
ARRENES	A)/RSENES
LANBONTES	LA/MBONTES
OYARIN	O)YA/RION
UPHRESIN	U(PHRE/SION
SAKIDIN	SAKI/DION
ZMILARIN	SMILA/RION
ANAPENPWMENOU	A)NAPEMPWME/NOU
ANFA	A)MFA/
ARRENWN	A)RSE/NWN
PROHNENKAMHN	PROHNEGKA/MHN
APOLLWNIN	*)APOLLW/NION
KATHNGISQH	KATHGGI/SQH
GRITARIN	GRITA/RION
EORTIN	E(O/RTION
APOLUTIKIN	A)POLUTI/KION
SUNKEKOLHMENOU	SUGKEKOLHME/NOU
TRITTON	TRISSO/N
TRIMHSIN	TRIMH/SION
ENKLHMATOS	E)GKLH/MATOS
SUNBOLA	SU/MBOLA
ENFEROMENWN	E)MFEROME/NWN
ENPOROS	E)/MPOROS
ANGION	*)/AGGION
ENKLHMATA	E)GKLH/MATA
ENGOUOU	E)GGOU/OU
ELATTWMENOU	E)LASSWME/NOU
ENGALO	E)/GGALO
PROSOPIDIN	PROSOPI/DION
SARAKIN	SARA/KION
KERATIN	KERA/TION
ENPROQESMOS	E)MPRO/QESMOS
ENPOLHS	E)MPOLH=S
KATALANBANEIN	KATALAMBA/NEIN
STIXARIN	STIXA/RION
NUMBER_0	I-number
MESENGUOU	MESEGGU/OU
SUNXWRW	SUGXWRW=
SUNSFAGIW	SUSFAGIW=
ENGENOUS	E)GGENOU=S
ANXHS	A)/GXHS
QENAPUNXIS	*QENAPU/GXIS
AMFIZBHTHSIN	A)MFISBH/THSIN
DIAMFIZBHTOUMENH	DIAMFISBHTOUME/NH
SUNXWRHSI	SUGXW/RHSI
HMIOBELIN	H(MIOBE/LION
ARGURIN	A)RGU/RION
ENLIPONTOS	E)LLIPO/NTOS
YENMWNQHS	*YEMMW/NQHS
SUNKLEISE	SU/GKLEISE
ENGOIS	E)/GGOIS
LOGARIDIN	LOGARI/DION
SUNKURONTWN	SUGKURO/NTWN
KANKELOU	KAGKE/LOU
EUANGELION	EU)AGGE/LION
SUNKLEISMOU	SUGKLEISMOU=
FWKARIN	FWKA/RION
XARTARIN	XARTA/RION
ENGGEGRAMMENOIS	E)GGEGRAMME/NOIS
EPIDHPER	E)PIDH/
KRHTARIN	KRHTA/RION
UPOPODIN	U(POPO/DION
ENKTHSEWN	E)GKTH/SEWN
ENGEGRAMMENOIS	E)GGEGRAMME/NOIS
ENGINETAI	E)GGI/NETAI
SUNPANTI	SU/MPANTI
TOUT'	TOUTI/
ENBAFIA	E)MBA/FIA
SUNXU	SU/GXU
KAQ'	KATO/
SUNPARALABONTES	SUMPARALABO/NTES
SUNPEFONHMENH	SUMPEFONHME/NH
LOGARIN	LOGA/RION
FOIBAMMMWN	*FOIBA/MMWN
PAREIDIN	PAREI/DION
PENYON	PE/MYON
MONASTHRIN	MONASTH/RION
HNFISBHTOUN	H)MFISBH/TOUN
PARENBOLHS	PAREMBOLH=S
ENFEROMENOI	E)MFERO/MENOI
SUNXWRHQHNAI	SUGXWRHQH=NAI
ANENGAREUTA	A)NEGGA/REUTA
LEITOURGIN	LEITOU/RGION
SUNKOMIZHS	SUGKOMI/ZHS
ZMARAGDINON	SMARA/GDINON
ARRENA	A)/RSENA
OYWNIN	O)YW/NION
ELADIN	E)LA/DION
ANMWNIOU	*)AMMWNI/OU
ANANKAIAN	A)NAGKAI/AN
ENPODIZHTAI	E)MPODI/ZHTAI
PROSANGELW	PROSAGGE/LW
PROSANGELAS	PROSAGGE/LAS
KONXISMA	KO/GXISMA
AG'	A)GE/
FELONIN	FELO/NION
KOLOBIN	KOLO/BION
ENBALOMHN	E)MBALO/MHN
KEKOMIZMAI	KEKO/MISMAI
PRINKIPW	PRIGKI/PW
LINARIN	LINA/RION
EKFORIN	E)KFO/RION
ENXRHSSOUSAI	E)GXRH/SSOUSAI
SUNLOUME	SULLOUME/
ENGUASQAI	E)GGUA=SQAI
ANANKASI	A)NA/GKASI
PARENXEIRH	PAREGXEI/RH
SENLEWN	SELLE/WN
DIONUSARIN	*DIONUSA/RION
ERWTARIN	E)RWTA/RION
SUNKATAQESIN	SUGKATA/QESIN
SUNPLHROUSIN	SUMPLHROU=SIN
SUNFWNA	SU/MFWNA
SUNBOULEUW	SUMBOULEU/W
TAPHTIN	TAPH/TION
AMFIZBHTOUMENWN	A)MFISBHTOUME/NWN
ENFANEIAS	E)MFANEI/AS
APUNXIOS	*)APU/GXIOS
ENBLEYAN	E)MBLE/YAN
DEZMWTHRIOU	DESMWTHRI/OU
ENLIPEI	E)LLIPEI=
KITWNIN	KITW/NION
LWTIKIN	LWTI/KION
SUNPEPTWKOIHS	SUMPEPTWKOI/HS
ENPOHSEWS	E)MPOH/SEWS
OCURUNXWN	O)CURU/GXWN
SUNKURWNTWN	SUGKURW/NTWN
ENGONOIS	E)GGO/NOIS
SUNBEBAIOSOMEN	SUMBEBAIO/SOMEN
ENPOIHSEWS	E)MPOIH/SEWS
SUNKURONTON	SUGKU/RONTON
SUNBEBAIWSWMEN	SUMBEBAIW/SWMEN
ENPECAS	E)MPE/CAS
EXONMEN	E)/XOMMEN
TESSSERWN	TESSE/RWN
PRINKEPOS	PRI/GKEPOS
ELATTOUMENOU	E)LASSOUME/NOU
SUNPARELABAN	SUMPARE/LABAN
AMENPTWS	A)ME/MPTWS
ENKALO	E)/GKALO
KINBER	*KI/MBER
ENGISE	E)/GGISE
PARANGEILEI	PARAGGEI/LEI
AMFIAZMOU	A)MFIASMOU=
AGORAZMATOS	A)GORA/SMATOS
AINGADWN	*AI)GGADW=N
GALERIN	GALE/RION
ENPOROIS	E)MPO/ROIS
EPENENKEIN	E)PENEGKEI=N
DROMITARIN	DROMITA/RION
PENTADIN	PENTA/DION
ENTUNXANW	E)NTUGXA/NW
STIXAROFELWNIN	STIXAROFELW/NION
FELWNIN	FELW/NION
SUNPIQOMAI	SUMPI/QOMAI
KROMUDIN	KROMU/DION
KOLOKUNQIN	KOLOKU/NQION
KATENENKASIN	KATENE/GKASIN
EPANANKES	E)PA/NAGKES
PEPONIN	PEPO/NION
GRANMATA	GRA/MMATA
ENKALON	E)/GKALON
METALHNYOMENOIS	METALHMYOME/NOIS
ZMHMA	SMH=MA
KATENGUHSEI	KATEGGUH/SEI
SUNXORO	SU/GXORO
ENKTHSEWS	E)GKTH/SEWS
SUNKURIWNTWN	SUGKURIW/NTWN
PARANGELHNAI	PARAGGELH=NAI
EPANGEILEIE	E)PAGGEI/LEIE
LANPROTATHS	LAMPROTA/THS
ECUS	E)SU/S
QEAFIN	QEA/FION
SUNSFRAGIOUSIN	SUSFRAGIOU=SIN
SUNSFRAGIW	SUSFRAGIW=
ANGELAS	A)GGE/LAS
PITTAKIN	PITTA/KION
FIALIN	FIA/LION
SFURIDIN	SFURI/DION
KANQHLIN	KANQH/LION
DIAPRATTE	DIA/PRASSE
ZMURNAN	SMU/RNAN
SUNPOSI	SU/MPOSI
KATASUNGRAFOUNTWN	KATASUGGRAFOU/NTWN
SUNPAN	SU/MPAN
AGXORINFEWS	*)AGXORI/MFEWS
SUNKURONTW	SUGKURO/NTW
SUNKEXWRHMENH	SUGKEXWRHME/NH
DELFAKIN	DELFA/KION
ONFIS	*)/OMFIS
OCEIDIN	O)CEI/DION
OLOKOTTININ	O(LOKOTTI/NION
ENGRAFENTWN	E)GGRAFE/NTWN
AMFIZBHTHSIS	A)MFISBH/THSIS
PARHNENKEN	PARH/NEGKEN
ANKHN	A)GKH=N
ENPUHSEWS	E)MPUH/SEWS
SUNBALLONTE	SUMBA/LLONTE
ENKEKLIKENAI	E)GKEKLIKE/NAI
SUNKEKLISQAI	SUGKEKLI/SQAI
SFRAGIDIN	SFRAGI/DION
ENENKHS	E)NE/GKHS
ANFOTEROIS	A)MFOTE/ROIS
KRITTONI	KRI/SSONI
KERBIKARIN	KERBIKA/RION
DIONUSIN	DIONU/SION
AZMENON	A)/SMENON
BOEIDIN	BOEI/DION
KARAKALLIN	KARAKA/LLION
ENBADIAN	E)MBADI/AN
SUNSKEUHS	SUSKEUH=S
EQIZMOU	E)QISMOU=
APHNENKANTO	A)PHNE/GKANTO
KATENGUHSETO	KATEGGUH/SETO
ENGISAI	E)GGI/SAI
PANMATI	PA/MMATI
ANANKH	A)NA/GKH
ANGELON	A)/GGELON
ANGELOS	A)/GGELOS
SUNSKEAZOMENOS	SUSKEAZO/MENOS
EPHNENKEN	E)PH/NEGKEN
SUNXWRWN	SUGXWRW=N
SUNXWRHSEOS	SUGXWRH/SEOS
SUNSTATIKHN	SUSTATIKH/N
KRITTONOS	KRI/SSONOS
ENGEGRAMMENA	E)GGEGRAMME/NA
SUNGRAFOFULAKI	SUGGRAFOFU/LAKI
ENKALESEIN	E)GKALE/SEIN
SUNPLH	SU/MPLH
SUNKROUEIN	SUGKROU/EIN
ENORMIN	E)NO/RMION
ENBEBLHSQAI	E)MBEBLH=SQAI
LONGOS	LOGGO/S
LONGOU	LOGGOU=
SUNKOMIZEIN	SUGKOMI/ZEIN
SUNPTWSEI	SUMPTW/SEI
ANKALAS	A)GKA/LAS
ENKATALIPEIN	E)GKATALIPEI=N
SUNXWRH	SUGXWRH=
KAMASIN	KAMA/SION
KAMISIN	KAMI/SION
SUNXRHMATIZOUSI	SUGXRHMATI/ZOUSI
SUNKUROUSWN	SUGKUROUSW=N
APOSUSSTATIKOU	A)POSUSTATIKOU=
PARASUNGRAFH	PARASUGGRAFH/
SUNBEBLHMENW	SUMBEBLHME/NW
SUNLHMFQEIS	SULLHMFQEI/S
ASUNKRITIOU	*)ASUGKRITI/OU
KAMISIOMAFORIN	KAMISIOMAFO/RION
OQONIN	O)QO/NION
SINDONIN	SINDO/NION
XOIRIDIN	XOIRI/DION
ENXEIRIDIN	E)GXEIRI/DION
ENGAIWN	E)GGAI/WN
ENBAFIN	E)MBA/FION
SUNKWMHTAI	SUGKWMH=TAI
TUNXANOMEN	TUGXA/NOMEN
KUAQIN	KUA/QION
ZWNARIN	ZWNA/RION
KWDWNIN	KWDW/NION
DAKTULIN	DAKTU/LION
SUNKLEISOMEN	SUGKLEI/SOMEN
ANGEIA	A)GGEI=A
EPHNGEILAMHN	E)PHGGEILA/MHN
POTHRIN	POTH/RION
CURAFIN	CURA/FION
ANKURWNWN	A)GKURW/NWN
SUNBOHQON	SUMBOHQO/N
ENKLHMA	E)/GKLHMA
DIAPENYAMENOU	DIAPEMYAME/NOU
ENGRAPTOU	E)GGRA/PTOU
SUNKRISIN	SU/GKRISIN
SUNZEUCON	SU/ZEUCON
SUNLEGOMENON	SULLEGO/MENON
MENFIN	*ME/MFIN
STIN	STI=ON
ENXEIRISQEISAN	E)GXEIRISQEI=SAN
ENGEGRAMMENOUS	E)GGEGRAMME/NOUS
SITARIN	SITA/RION
HNARIN	H)NA/RION
SUNKWMHTHS	SUGKWMH/THS
ENKALOUME	E)GKALOU=ME
OIPER	OI(
ENKALOUME	E)GKALOU=ME
ENKTHSEWN	E)GKTH/SEWN
SUNKEXWRHKENAI	SUGKEXWRHKE/NAI
ENGONON	E)/GGONON
TRIODONTIN	TRIODO/NTION
EP'	E)PI/
KATABOLIN	KATABO/LION
ENKATALIYANTA	E)GKATALI/YANTA
SUNLITOURGOIS	SULLITOURGOI=S
EPENYATAI	E)PEMYA=TAI
QARROUN	QARSOU=N
EISANGELLOMEN	EI)SAGGE/LLOMEN
SUNKEIMENOU	SUGKEIME/NOU
SUNXWRHSON	SUGXW/RHSON
SUNBION	SU/MBION
ENGUHTH	E)GGUHTH/
LONGINOS	*LOGGI=NOS
ENXEIRISQHNAI	E)GXEIRISQH=NAI
ENPIPTOUSWN	E)MPIPTOUSW=N
ZEUGARIN	ZEUGA/RION
ASUNKRITE	A)SU/GKRITE
ENGONOU	E)GGO/NOU
SUNBOLHS	SUMBOLH=S
ENKALESAI	E)GKALE/SAI
SUNBIWSEWS	SUMBIW/SEWS
SUNPARAKALESH	SUMPARAKALE/SH
SUNKLASQENTWN	SUGKLASQE/NTWN
DOCARIN	DOCA/RION
KRABATIN	KRABA/TION
SUNPARONTOS	SUMPARO/NTOS
ANTISUNGRAFA	A)NTISU/GGRAFA
ENKUKLION	E)GKU/KLION
STRONGULOPROSWPON	STROGGULOPRO/SWPON
SUNGRAFHN	SUGGRAFH/N
ENPOIHQH	E)MPOIHQH=
ENKALESH	E)GKALE/SH
SUNLAMBANESQAI	SULLAMBA/NESQAI
SUNKEXWRHKASI	SUGKEXWRH/KASI
SUNBIW	SUMBI/W
SUNLHMFQENTI	SULLHMFQE/NTI
MENXHS	*MEGXH=S
PANXARI	PA/GXARI
EKDIKIN	E)KDI/KION
POIMENIN	POIME/NION
SUNLABWMENOS	SULLABWME/NOS
ARRHNIKAS	*)ARSHNIKA/S
ANFODOU	A)MFO/DOU
OPER	O(
SUNXISI	SUGXI/SI
PARANGELIAN	PARAGGELI/AN
ANANKAIN	A)NA/GKAIN
SUNKOMIDHS	SUGKOMIDH=S
SUNKLISQHS	SUGKLISQH=S
MENFOMAI	ME/MFOMAI
EMENYANTO	E)ME/MYANTO
PARANBALLOUSWN	PARAMBALLOUSW=N
ANKURWN	A)GKURW=N
ELATTOSIN	E)LA/SSOSIN
ENGUOS	E)/GGUOS
SUNKEXWRHKAN	SUGKEXW/RHKAN
PARASUNGRAFOUNTES	PARASUGGRAFOU=NTES
DAKTULIDIN	DAKTULI/DION
ENGALW	E)GGA/LW
SUNKEXWRHMENHN	SUGKEXWRHME/NHN
ANGURA	A)/GGURA
ENKEIMENHN	E)GKEIME/NHN
ENGUHS	E)GGU/HS
HNENKEN	H)/NEGKEN
NOMIZMATIA	NOMISMA/TIA
THGANIN	THGA/NION
ENKALESSEIN	E)GKALE/SSEIN
UPOMNHMATIZMO	U(POMNHMATISMO/
KATAGWGIN	KATAGW/GION
ENGEGRAMMENAIS	E)GGEGRAMME/NAIS
APF'	A)PFA/
OMFALIN	O)MFA/LION
ENKALESANTA	E)GKALE/SANTA
ENKALESONTA	E)GKALE/SONTA
PERIERONXASEN	PERIERO/GXASEN
EPANANKASAN	E)PANAGKA/SAN
HNENENKEN	H)NE/NEGKEN
PANKRATEI	PAGKRATEI=
PANKRATI	*PAGKRA/TI
OUNKIAS	OU)GKI/AS
ALLHLENGUIHS	A)LLHLEGGUI/+HS
HNHNKASE	H)NH/GKASE
SUNLOGHSATE	SULLOGH/SATE
ONMATOS	O)/MMATOS
PANKRATOU	PAGKRATOU=
PANKRATEIS	PAGKRATEI=S
SALWTIN	SALW/TION
PELUKIN	PELU/KION
ENENKENAI	E)NEGKE/NAI
ZMAMA	SMA=MA
ENGUOUME	E)GGUOU=ME
SUNKATERAYA	SUGKATE/RAYA
SUNBEIW	SUMBEI/W
EUTUXIN	EU)TU/XION
ENGUWME	E)GGUWME/
ENPOOUMENOU	E)MPOOUME/NOU
KRATTIN	KRA/SSIN
ENKEKRAMMENA	E)GKEKRAMME/NA
MELANPARWIA	MELAMPARWI/A
SUNBIBA	SUMBI/BA
KABIDIN	KABI/DION
PENPW	PE/MPW
ENFANIAS	E)MFANI/AS
SFINKTHRION	SFIGKTH/RION
ECENENKEIN	E)CENEGKEI=N
ERRWQE	*(ERSW/QE
EIANPER	EI)A/N
ZMHNH	SMH/NH
PWMARIN	PWMA/RION
MANGANWN	MAGGA/NWN
PARENBOLOU	PAREMBO/LOU
ENMELIA	E)MMELI/A
KORDIKIN	KORDI/KION
ZMURNHS	SMU/RNHS
ENGUOI	E)/GGUOI
ENFANIAN	E)MFANI/AN
ENGUWMEN	E)GGUW=MEN
ANENENKEIN	A)NENEGKEI=N
MENFEWN	*MEMFE/WN
SUNXWRHQHSESAI	SUGXWRHQH/SESAI
SUNPARONTES	SUMPARO/NTES
ANENENKATWN	A)NENEGKA/TWN
GONGULIDHS	GOGGULI/DHS
SUNSUNTACEIN	SUSSUNTA/CEIN
SUNKATELUOSAN	SUGKATELU/OSAN
SITOMETRIN	SITOME/TRION
SUNKATARASSWN	SUGKATARA/SSWN
EISENENKEI	EI)SENEGKEI=
ENLO	E)LLO/
UPOTUNXANWN	U(POTUGXA/NWN
SURINGES	SU/RIGGES
PORFURIN	PORFU/RION
FAKEIARIN	*FAKEI+A/RION
PARENPOLH	PAREMPOLH/
PRAITWRIN	PRAITW/RION
PEDALIN	PEDA/LION
ANBLEPEI	A)MBLE/PEI
SUNKROTHSE	SUGKRO/THSE
EXARIN	E)XA/RION
KANGELOU	KAGGE/LOU
KIQWNIN	KIQW/NION
ENGRAFWS	E)GGRA/FWS
ENGEGRAMMENON	E)GGEGRAMME/NON
ENXRHZONTES	E)GXRH/ZONTES
ENXRHZONTA	E)GXRH/ZONTA
AMPER	A)/M
ENGEGUHMAI	E)GGEGU/HMAI
SUNGRAFHS	SUGGRAFH=S
SUNRIGGAS	SU/RRIGGAS
MENFEIS	ME/MFEIS
EPISEIZMOIS	E)PISEISMOI=S
ENXEONTES	E)GXE/ONTES
ENBHNAI	E)MBH=NAI
QINGANEIN	QIGGA/NEIN
GONGULH	GOGGU/LH
ENGIZONTOS	E)GGI/ZONTOS
SUNPEFWNHMENHS	SUMPEFWNHME/NHS
ANKWNOS	A)GKW=NOS
ENGUOMEQA	E)GGUO/MEQA
LOIPADARIN	LOIPADA/RION
ENGUHTHN	E)GGUHTH/N
ENKLISON	E)/GKLISON
SUNPLHRWSEI	SUMPLHRW/SEI
ATARIN	A)TA/RION
DIONKION	DIO/GKION
ENKLISQHNAI	E)GKLISQH=NAI
SUNPAQIN	SUMPA/QION
HPATIN	H(PA/TION
APOLINPANOMENON	A)POLIMPANO/MENON
ANGRAFON	A)GGRA/FON
SUNFWNIAN	SUMFWNI/AN
SUNPRATTONTI	SUMPRA/SSONTI
SUNKUROUNTWN	SUGKUROU/NTWN
OCURUNXITWN	*)OCURUGXITW=N
SUNKAMNONTAS	SUGKA/MNONTAS
ONKON	O)/GKON
APHNGEILA	A)PH/GGEILA
ANANKASETW	A)NAGKASE/TW
ARRON	A)/RSON
ENENKAS	E)NE/GKAS
ECONPLARIN	E)COMPLA/RION
PARANGELENTAS	PARAGGELE/NTAS
ANGEIW	A)GGEI/W
MANGANARIW	MAGGANARI/W
PROSENENKEIN	PROSENEGKEI=N
KATHNGUA	KATHGGU/A
LANBANWN	LAMBA/NWN
ESSFRAGIZMENA	E)SSFRAGISME/NA
ENGISTOS	E)/GGISTOS
UPENGUON	U(PE/GGUON
PROSANGELMA	PROSA/GGELMA
SUNGENIAS	SUGGENI/AS
LELONXEN	LE/LOGXEN
ANKWNI	A)GKW=NI
APHNGELH	A)PHGGE/LH
SXIDARIN	SXIDA/RION
ANPASAS	A)MPA/SAS
PROSKEFALIN	PROSKEFA/LION
NOMIZMATION	NOMISMA/TION
ENXRHSEWN	E)GXRH/SEWN
CUGGENWN	SUGGENW=N
CUNGENEIAS	CUGGE/NEIAS
PRAKTHRRI	PRAKTH=RSI
ENKINDUNEUEIN	E)GKINDUNEU/EIN
ENGUWMEQA	E)GGUW/MEQA
EPANGELLON	E)PAGGE/LLON
BIOTIN	BIO/TION
APOLLWNARIN	*)APOLLWNA/RION
ANPELONA	A)MPE/LONA
PRINGIPI	PRI/GGIPI
SIMARIN	SIMA/RION
SANGAQA	SA/GGAQA
SANGAQWN	SAGGA/QWN
SUNSKEUAZESQAI	SUSKEUA/ZESQAI
ENGUHN	E)GGU/HN
NUNFEUSEIS	NUMFEU/SEIS
ENENKEIN	E)NEGKEI=N
SIDHRIN	SIDH/RION
ONARIN	O)NA/RION
SUNPEFWNMENAS	SUMPEFWMME/NAS
ENPOIHSOMENON	E)MPOIHSO/MENON
KATENENKWMEN	KATENE/GKWMEN
SUNPARADWSW	SUMPARADW/SW
KATENENKOUMEN	KATENEGKOU=MEN
SUNPAREILHFA	SUMPAREI/LHFA
SUNLAMBANOUSHS	SULLAMBANOU/SHS
SUNBALE	SU/MBALE
ENGRAMENA	E)GGRAME/NA
ANENKLHSIAS	A)NEGKLHSI/AS
APOSUSSTAQENTES	A)POSUSTAQE/NTES
NUNFIKA	NUMFIKA/
KATENGUHSAS	KATEGGUH/SAS
ENGUHSAMENWN	E)GGUHSAME/NWN
GUNAIKIN	GUNAI/KION
SAPPIRIN	SAPPI/RION
ENKLISQENTWN	E)GKLISQE/NTWN
ANFOTEROI	A)MFO/TEROI
PROHNENKAN	PROH/NEGKAN
OIPER	OI(
LELONXENAI	LELOGXE/NAI
SUNSESHMIWMAI	SUSSESHMI/WMAI
XALADRIN	XALA/DRION
PAIDOTROFIN	PAIDOTRO/FION
ETOIMAKIN	*(ETOIMA/KION
DERMATIKIN	DERMATI/KION
SUNXERW	SUGXERW=
PARHNENKAS	PARH/NEGKAS
ENENKWMEN	E)NE/GKWMEN
MARREI	*MARSEI=
MARREUS	*MARSEU/S
MARRWN	*MARSW=N
SUNPESIN	SU/MPESIN
SUNPESAI	SUMPE/SAI
AGAQIN	A)GA/QION
ENLABONTA	E)LLABO/NTA
ANLH	A)/LLH
DIAMFIZBHTHSEWS	DIAMFISBHTH/SEWS
MENFITHS	*MEMFI/THS
DIDUMARIN	DIDUMA/RION
CULOTOMIN	CULOTO/MION
SUNPARHMI	SUMPA/RHMI
ENPRHSQEISA	E)MPRHSQEI=SA
ELATTWNAIS	*)ELA/SSWNAIS
ANGARIOUS	A)GGARI/OUS
ELENCAS	E)LE/GCAS
OMOLOGIN	O(MOLO/GION
EPHNHNKASEN	E)PHNH/GKASEN
EPHNHNKEN	E)PH/NHGKEN
EPANANKASQHNAI	E)PANAGKASQH=NAI
PROHNENKATW	PROHNEGKA/TW
PANKRATHS	PAGKRATH/S
AMMMWNIOS	*)AMMW/NIOS
DEMATIN	DEMA/TION
BIHNXIS	*BIH=GXIS
ENKALOUMENWN	E)GKALOUME/NWN
PITAKIN	PITA/KION
LONXEUS	LO/GXEUS
ENBAINONTA	E)MBAI/NONTA
ENBAINWN	E)MBAI/NWN
PARANGEILH	PARAGGEI/LH
PARANGELEIAS	PARAGGELEI/AS
EPIPER	E)PI/
EPIXEIRIN	E)PIXEI/RION
SUNSTASEWS	SUSTA/SEWS
SUNSTAQENTA	SUSTAQE/NTA
ENMELIAN	E)MMELI/AN
SUNPARELABANAMEN	SUMPARELABA/NAMEN
EPANGELEIAS	E)PAGGELEI/AS
HMITULIN	H(MITU/LION
KURRIOU	KURSI/OU
SUNLABOUSA	SULLABOU=SA
PARASFRAGIZMON	PARASFRAGISMO/N
SUNBOLH	SUMBOLH/
SUNBWLH	SUMBWLH/
SUNBWLHS	SUMBWLH=S
ENKATALABANW	E)GKATALABA/NW
DEI'	DE/IO
ERGALIDIN	E)RGALI/DION
SUNKOMISAMHN	SUGKOMISA/MHN
MENXEIOUS	*MEGXEIOU=S
LONXIA	LOGXI/A
MISQARIN	MISQA/RION
ANFESTIW	A)MFESTIW=
IN'	I)NI/
ENENKW	E)NE/GKW
SUNGENHN	SUGGENH/N
TOUNPALIN	TOU/MPALIN
ENKLEISIS	E)/GKLEISIS
ZMHNEA	SMH/NEA
EPANANKASAS	E)PANAGKA/SAS
DEZMAS	DE/SMAS
TASOUXARIN	*TASOUXA/RION
QAISARIN	*QAISA/RION
SUNPEPTWKUIHS	SUMPEPTWKUI/HS
KATALOXIZMWN	KATALOXISMW=N
SUNKEXWRHMENHS	SUGKEXWRHME/NHS
SUNFUTAI	SU/MFUTAI
ENPUHSEOS	E)MPUH/SEOS
ENPOHSEOS	E)MPOH/SEOS
ENPOIHSIN	E)MPOI/HSIN
APUNXEWS	*)APU/GXEWS
ENGALESI	E)GGA/LESI
SUNMIKTON	SU/MMIKTON
SUNXOROUSI	SUGXOROU=SI
SUNKENWS	SUGKE/NWS
LELONXAN	LE/LOGXAN
LELONXA	LE/LOGXA
LANBANONTOS	LAMBA/NONTOS
SUNPOLWN	SUMPOLW=N
LANBANOUSA	LAMBA/NOUSA
ENKALESEI	E)GKALE/SEI
EPANANKAN	E)PANAGKA=N
SUNXOROUMEN	SUGXOROU=MEN
GONGULIDOS	GOGGULI/DOS
SUNKURWN	SUGKURW=N
ANXIO	*)/AGXIO
ELATTOUMENHS	E)LASSOUME/NHS
SFONGOU	SFO/GGOU
TRAXHLIN	TRAXH/LION
DRAPANIN	DRAPA/NION
OUNKIWN	OU)GKIW=N
ENKUKLEIO	E)GKUKLEI=O
ENGEGUHSQAI	E)GGEGUH=SQAI
MELANXRHS	MELAGXRH/S
ANFOTERWN	A)MFOTE/RWN
ENGAREUEIN	E)GGAREU/EIN
PROSANGELLW	PROSAGGE/LLW
ONKIAS	O)GKI/AS
ENBALOU	E)MBALOU=
SUNLABE	SU/LLABE
ENPORIAN	E)MPORI/AN
ENPORIAS	E)MPORI/AS
PANPOLLA	PA/MPOLLA
PAIDARIN	PAIDA/RION
DIAKONIN	DIAKO/NION
ENKALOUMENOUS	E)GKALOUME/NOUS
SUNPEFWNHMENHN	SUMPEFWNHME/NHN
EPENHNKW	E)PENH/GKW
SUNBOLON	SU/MBOLON
SUNPNEEIN	SUMPNE/EIN
DIDASKALIN	DIDASKA/LION
SUNBIOU	SUMBI/OU
PETTAKION	PESSA/KION
ZMHSASQAI	SMH/SASQAI
ENPROQES	E)MPRO/QES
ENKUKLEI	E)GKUKLEI=
SUNBIWSEOS	SUMBIW/SEOS
ENGRAFWS	E)GGRA/FWS
ANFILOGIAS	A)MFILOGI/AS
PENYEIS	PE/MYEIS
ERROS	*(/ERSOS
TEMAXIN	TEMA/XION
ENKELEUSEWS	E)GKELEU/SEWS
LONXI	LOGXI/
SUNPOLITH	SUMPOLI/TH
SUNKELLARIOUS	SUGKELLARI/OUS
KATAGRAFIN	KATAGRA/FION
ENKEFALON	E)GKE/FALON
ZMOU	SMOU=
PENYAI	PE/MYAI
UPANKONION	U(PAGKONI=ON
HPHTIN	H)PH/TION
FALANGES	FA/LAGGES
KOZMHTIAS	KOSMHTI/AS
XLANIDIN	XLANI/DION
ENPROSTON	E)MPROSTO/N
PANKALON	PA/GKALON
PANKALA	PA/GKALA
KAMALAUKIN	KAMALAU/KION
SUNBANTA	SUMBA/NTA
OINARIN	OI)NA/RION
KATALANBANW	KATALAMBA/NW
GONGUSMOS	GOGGUSMO/S
KAQ'	KATO/
ENGRAFOU	E)GGRA/FOU
EIRGAZMENOI	EI)RGASME/NOI
ANANKASQHSOMEQA	A)NAGKASQHSO/MEQA
HNENKAN	H)/NEGKAN
TEQERIZMENWN	TEQERISME/NWN
PROANGELMA	PROA/GGELMA
MENFEI	ME/MFEI
DEZMAI	DE/SMAI
KATEIRGAZMENON	KATEIRGASME/NON
